wwwwwwwwwwwwwwwwwwwwwwwwwwwwwwwwwwwwwwwwwwwwwwww
wg....w......w........w........w.....w......w.Bw
wg....w......w....w...w...w....w.....w......w..w
wg....w......w....w...w...w..........w......w..w
wg....w......w....w...w...w....w............w..w
wg....w...........w...w...w....w.....w......w..w
wg....w......w....w...w...w....w.....w.........w
wg...........w....w............w.....w......w..w
wwwwwwwwwwwwwwwwwwwwwwwwwwwwwwwwwwwwwwwwwwwwwwww