wwwwwwwwwwwwwwwwwwwwwwwwwwwwwwwwwwwwwwwwwwwwwwww
wg.www..w...www.........w.ww.w...w............Bw
wg......w...........w............w..ww..w.w....w
wg.www......www.........wwwww..................w
wg......w..w........w...w........w...ww........w
wg.www..w...www.........w.................w....w
wg......w.......w...w...w........w....w........w
wg.www..w...wwwww...w....w..........www....w...w
wwwwwwwwwwwwwwwwwwwwwwwwwwwwwwwwwwwwwwwwwwwwwwww