wwwwwwwwwwwwwwwwwwwwwwwwwwwwwwwwwwwwwwwwwwwwwwww
w..www..w...www.........w.ww.w...w............gw
w.......w...........w............w..ww..w.w...gw
w..www......www.........wwwww.................gw
w.......w..w........w...w........w...ww.......gw
wA.www..w...www.........w.................w...gw
w.......w.......w...w...w........w....w.......gw
w..www..w...wwwww...w....w..........www....w..gw
wwwwwwwwwwwwwwwwwwwwwwwwwwwwwwwwwwwwwwwwwwwwwwww