wwwwwwwwwwwwwwwwwwwwwwwwwwwwwwwwwwwwwwwwwwwwwwww
w...ww.........w......w..w..........w.....w...gw
w...w.......w.....w......w..........w..w......gw
w...ww......w..w......w...................w...gw
w....w.w....w.....w...w..w.wwwww....w..w......gw
wA...w.w.......w......w..w.....w....w.....w...gw
w....w.w....w.....w...w...wwww.w.......w......gw
w...........w..................w....w.....w...gw
wwwwwwwwwwwwwwwwwwwwwwwwwwwwwwwwwwwwwwwwwwwwwwww