wwwwwwwwwwwwwwwwwwwwwwwwwwwwwwwwwwwwwwwwwwwwwwww
w.............................................gw
w.....................................w.......gw
wA..............wwwwwww...............w.......gw
w...ww..........w.....w...............w.......gw
w....w..........w.....w.......w.......w.......gw
w....w......w...w............ww.......w.......gw
w....w......w...w...........www.......w.......gw
wwwwwwwwwwwwwwwwwwwwwwwwwwwwwwwwwwwwwwwwwwwwwwww