wwwwwwwwwwwwwwwwwwwwwwwwwwwwwwwwwwwwwwwwwwwwwwww
wA.........w....w........w.....w..............gw
wh...w.....w......w.....w.......wwwwwwwwwwww..gw
wh...w...........w.............w.........w....gw
wh...w...w......w.....ww..ww.............w....gw
wh.......w...w..w.........w...wwww.wwwwwwwwwwwgw
wh.......w......w....w................w......wgw
wh.......w...w.......w..................www...gw
wwwwwwwwwwwwwwwwwwwwwwwwwwwwwwwwwwwwwwwwwwwwwwww