wwwwwwwwwwwwwwwwwwwwwwwwwwwwwwwwwwwwwwwwwwwwwwww
w.....w......w........w........w.....w......w.gw
w.....w......w....w...w...w....w.....w......w.gw
w.....w......w....w...w...w..........w......w.gw
w.....w......w....w...w...w....w............w.gw
wA....w...........w...w...w....w.....w......w.gw
w.....w......w....w...w...w....w.....w........gw
w............w....w............w.....w......w.gw
wwwwwwwwwwwwwwwwwwwwwwwwwwwwwwwwwwwwwwwwwwwwwwww