wwwwwwwwwwwwwwwwwwwwwwwwwwwwwwwwwwwwwwwwwwwwwwww
wg.............w..............................hw
wg............w...................wwwwwwwwwwwwnw
wg...........w....................w...........rw
wgw.....................A.........w............w
wg...........w....................w...........rw
wg............w...................wwwwwwwwwwwwrw
wg.............w..............................tw
wwwwwwwwwwwwwwwwwwwwwwwwwwwwwwwwwwwwwwwwwwwwwwww