wwwwwwwwwwwwwwwwwwwwwwwwwwwwwwwwwwwwwwwwwwwwwwww
wg..ww.........w......w..w..........w.....w....w
wg..w.......w.....w......w..........w..w.......w
wg..ww......w..w......w...................w....w
wg...w.w....w.....w...w..w.wwwww....w..w......Bw
wg...w.w.......w......w..w.....w....w.....w....w
wg...w.w....w.....w...w...wwww.w.......w.......w
wg..........w..................w....w.....w....w
wwwwwwwwwwwwwwwwwwwwwwwwwwwwwwwwwwwwwwwwwwwwwwww